type octile
height 16
width 32
map
................................
...@@........@.......@@@@@@.....
...@@@@@......@@@......@@@@@....
..@@.........@@@@@.......@@.....
..@........@@@@@@@@@......@.....
..........@@@@.@..@@@...........
.....@@@.@@@........@@@.........
....@@@@@@@.........@@@@@.......
.......@@@..........@@@@........
................@@@.@@.......@..
............@..@@@@@@.......@@..
.....@@....@@@@@@@@@......@@@...
......@@@@..@@@.@@.......@@@@...
.......@@@@@@@@..@@......@@@@...
..........@@@@..............@...
............@...................
